XXXXXX__cxc_________
_____W__________ccc_
_____W_____c________
___XXXXX_______XX___
____________________
Ccc_______cCc____ccc

____________________
WWWWWWWWWWWWWWWWWWWW
____________________
____________________
wwWWWww______wwWWWww
